◌◌◌◌◌◌◌◌◌◌◌◌◌◌◌◌◌◌◌◌◌◌◌◌◌◌◌◌◌◌◌◌◌◌◌◌◌◌◌◌◌◌◌◌◌◌◌◌◌◌◌◌◌◌◌◌◌◌
◌▇◌▇▇▇▇▇▇▇▇▇▇▇▇▇▇▇▇▇▇▇▇▇▇▇▇▇▇▇▇▇▇▇▇▇▇▇▇▇▇▇◌▇▇▇▇▇▇▇▇▇▇▇▇▇◌▇
◌◌◌◌◌◌◌◌◌◌◌◌◌◌◌◌◌◌◌◌◌◌◌◌◌◌◌◌◌◌◌◌◌◌◌◌◌◌◌◌◌◌◌◌◌◌◌◌◌◌◌◌◌◌◌◌◌◌
◌▇◌▇◌▇◌▇▇▇▇▇◌▇▇▇◌▇▇▇◌▇▇▇▇▇▇▇▇▇◌▇◌▇◌▇◌▇◌▇▇▇▇▇▇▇▇▇▇▇▇▇▇▇▇▇◌▇
◌▇◌▇◌▇◌◌◌◌◌▇◌◌◌▇◌◌◌▇◌◌◌◌◌◌◌◌◌◌◌▇◌▇◌▇◌◌◌◌◌◌◌◌◌◌◌◌◌◌◌◌◌◌◌◌◌▇
◌▇◌▇▇▇▇▇◌▇▇▇◌▇▇▇▇▇◌▇▇▇▇▇▇▇◌▇▇▇▇▇◌▇▇▇▇▇▇▇▇▇◌▇▇▇▇▇▇▇▇▇▇▇▇▇◌▇
◌◌◌◌◌◌◌▇◌◌◌▇◌◌◌◌◌▇◌◌◌◌◌◌◌▇◌◌◌◌◌▇◌◌◌◌◌◌◌◌◌◌◌◌◌◌◌◌◌◌◌◌◌◌◌◌◌◌
◌▇◌▇▇▇◌▇◌▇▇▇◌▇▇▇◌▇◌▇◌▇◌▇◌▇▇▇◌▇▇▇◌▇◌▇◌▇◌▇▇▇▇▇▇▇▇▇◌▇▇▇▇▇▇▇◌▇
◌◌◌◌◌▇◌◌◌◌◌▇◌◌◌◌◌◌◌▇◌▇◌▇◌◌◌▇◌◌◌▇◌▇◌▇◌▇◌◌◌◌◌◌◌◌◌◌◌▇◌◌◌◌◌◌◌▇
◌▇◌▇▇▇◌▇▇▇◌▇◌▇◌▇▇▇◌▇▇▇▇▇◌▇▇▇◌▇▇▇◌▇▇▇▇▇▇▇▇▇◌▇▇▇▇▇▇▇▇▇▇▇◌▇◌▇
◌▇◌◌◌▇◌◌◌◌◌◌◌▇◌◌◌▇◌▇◌◌◌▇◌◌◌▇◌▇◌▇◌◌◌◌◌◌◌◌◌◌◌▇◌◌◌◌◌◌◌◌◌◌◌▇◌▇
◌▇◌▇◌▇◌▇◌▇▇▇◌▇◌▇◌▇◌▇◌▇▇▇▇▇▇▇◌▇◌▇◌▇◌▇▇▇▇▇◌▇▇▇▇▇▇▇◌▇◌▇◌▇◌▇◌▇
◌◌◌▇◌◌◌▇◌◌◌◌◌◌◌◌◌◌◌◌◌◌◌◌◌◌◌▇◌▇◌◌◌▇◌◌◌◌◌▇◌◌◌◌◌◌◌◌◌◌◌▇◌▇◌◌◌▇
◌▇◌▇◌▇◌▇◌▇◌▇▇▇◌▇◌▇◌▇▇▇▇▇◌▇▇▇◌▇◌▇▇▇◌▇▇▇◌▇▇▇◌▇▇▇◌▇◌▇◌▇◌▇◌▇◌▇
◌◌◌◌◌▇◌◌◌◌◌◌◌◌◌▇◌◌◌◌◌◌◌▇◌▇◌◌◌◌◌▇◌◌◌▇◌◌◌◌◌◌◌◌◌◌◌▇◌▇◌◌◌◌◌◌◌◌
◌▇◌▇◌▇◌▇◌▇◌▇◌▇▇▇◌▇▇▇◌▇◌▇◌▇◌▇▇▇◌▇◌▇◌▇◌▇◌▇◌▇◌▇◌▇◌▇◌▇▇▇◌▇◌▇◌▇
◌▇◌◌◌▇◌◌◌▇◌◌◌◌◌◌◌▇◌◌◌▇◌◌◌◌◌◌◌▇◌◌◌◌◌◌◌◌◌◌◌◌◌▇◌◌◌◌◌◌◌◌◌▇◌▇◌▇
◌▇◌▇◌▇◌▇▇▇◌▇◌▇▇▇▇▇◌▇▇▇◌▇▇▇▇▇◌▇◌▇◌▇◌▇◌▇◌▇▇▇◌▇▇▇◌▇◌▇◌▇◌▇◌▇◌▇
◌◌◌▇◌◌◌▇◌◌◌▇◌◌◌▇◌◌◌◌◌◌◌▇◌◌◌◌◌◌◌▇◌▇◌◌◌▇◌◌◌◌◌▇◌◌◌◌◌▇◌▇◌◌◌◌◌▇
◌▇◌▇◌▇◌▇◌▇◌▇◌▇◌▇◌▇◌▇◌▇◌▇◌▇◌▇▇▇◌▇◌▇◌▇◌▇◌▇◌▇◌▇▇▇▇▇◌▇◌▇▇▇◌▇◌▇
◌▇◌◌◌◌◌◌◌◌◌◌◌◌◌◌◌◌◌▇◌◌◌◌◌◌◌◌◌◌◌◌◌◌◌▇◌◌◌◌◌◌◌▇◌▇◌◌◌▇◌◌◌◌◌▇◌▇
◌▇◌▇◌▇◌▇◌▇◌▇◌▇◌▇◌▇◌▇◌▇◌▇◌▇▇▇◌▇▇▇◌▇▇▇◌▇▇▇▇▇◌▇◌▇▇▇◌▇▇▇▇▇▇▇◌▇
◌◌◌▇◌▇◌◌◌▇◌◌◌▇◌▇◌▇◌◌◌▇◌◌◌◌◌◌◌◌◌◌◌▇◌▇◌▇◌◌◌◌◌◌◌◌◌▇◌◌◌◌◌▇◌◌◌▇
◌▇◌▇◌▇◌▇▇▇◌▇◌▇◌▇◌▇◌▇▇▇◌▇▇▇◌▇◌▇▇▇▇▇◌▇◌▇◌▇◌▇▇▇▇▇◌▇▇▇▇▇◌▇▇▇◌▇
◌◌◌◌◌◌◌◌◌◌◌▇◌◌◌◌◌◌◌◌◌◌◌◌◌◌◌▇◌◌◌▇◌▇◌▇◌◌◌▇◌◌◌▇◌▇◌◌◌◌◌▇◌◌◌▇◌▇
◌▇◌▇◌▇◌▇◌▇▇▇◌▇▇▇▇▇◌▇◌▇▇▇◌▇◌▇◌▇▇▇◌▇◌▇◌▇◌▇▇▇◌▇◌▇▇▇▇▇◌▇▇▇◌▇◌▇
◌▇◌◌◌▇◌◌◌◌◌◌◌◌◌◌◌▇◌◌◌◌◌◌◌▇◌◌◌◌◌◌◌▇◌▇◌◌◌▇◌◌◌◌◌◌◌▇◌◌◌▇◌◌◌◌◌▇
◌▇◌▇◌▇◌▇◌▇◌▇▇▇▇▇▇▇◌▇▇▇▇▇◌▇◌▇◌▇▇▇▇▇◌▇◌▇▇▇◌▇▇▇▇▇◌▇▇▇◌▇▇▇▇▇◌▇
◌◌◌▇◌◌◌▇◌◌◌▇◌◌◌◌◌◌◌▇◌◌◌▇◌◌◌▇◌▇◌◌◌▇◌◌◌▇◌▇◌▇◌◌◌▇◌▇◌▇◌▇◌▇◌▇◌▇
◌▇◌▇◌▇◌▇◌▇▇▇◌▇◌▇▇▇▇▇◌▇▇▇◌▇▇▇◌▇◌▇▇▇◌▇▇▇◌▇◌▇▇▇◌▇◌▇◌▇◌▇◌▇◌▇◌▇
◌▇◌◌◌▇◌▇◌◌◌▇◌▇◌▇◌▇◌▇◌▇◌◌◌◌◌▇◌▇◌◌◌◌◌▇◌▇◌▇◌▇◌◌◌▇◌▇◌◌◌▇◌▇◌◌◌▇
◌▇◌▇◌▇◌▇◌▇▇▇◌▇◌▇◌▇◌▇◌▇◌▇▇▇▇▇◌▇◌▇▇▇▇▇◌▇◌▇◌▇◌▇▇▇◌▇▇▇◌▇◌▇▇▇◌▇
◌◌◌▇◌◌◌◌◌◌◌◌◌◌◌◌◌◌◌◌◌◌◌◌◌◌◌◌◌◌◌◌◌◌◌◌◌◌◌◌◌◌◌◌◌◌◌◌◌◌◌◌◌◌◌◌◌◌
◌▇◌▇▇▇▇▇▇▇▇▇▇▇▇▇▇▇▇▇▇▇▇▇▇▇▇▇▇▇▇▇▇▇▇▇▇▇◌▇▇▇◌▇▇▇▇▇▇▇▇▇▇▇▇▇◌▇
